NO textures/wolfenstein/grey_stone.xpm
SO textures/wolfenstein/purple_stone.xpm
WE textures/wolfenstein/red_brick.xpm
EA textures/wolfenstein/wood.xpm

F 156,155,155
C 204,229,255

        111111111111111111111
        100000000110000000001
        101100001110000000001
        100100000000000000001
11111111101100001110000000001
10000011101100001110111101111
11110S11111111111000000111111
1111011111111111101010010001
1100000011010111100000010001
1000000000000000000000000001 
1000000000000001101010010001
1100000111010111111011110001
11110111 111011 101111010001
11111111 111111 111111111111
