NO textures/wolfenstein/grey_stone.xpm
SO textures/wolfenstein/purple_stone.xpm
WE textures/wolfenstein/red_brick.xpm
EA textures/wolfenstein/wood.xpm

F 18,53,25
C 153,204,255

  
1 1111
11101
10S011
10001
11111
