NO textures/wolfenstein/grey_stone.xpm
SO textures/wolfenstein/purple_stone.xpm
WE textures/wolfenstein/red_brick.xpm
EA textures/wolfenstein/wood.xpm

F 18,53,25
C 153,204,255

  111111
 11000011
110S0011
11110011
 1011111
 111
